11111111111111111111
10P00000000000000001
10000011111000000001
10000000000000000001
10000000001111000001
10010000000001000001
10010000000001100001
10010000000000100001
10010000000000100001
10000000000000000001
10000000000000000001
10001111100000000001
10000000000000000001
10000010000000000001
10001110000111100001
10000010000000000001
10000010000000000001
10000000000000000001
10000000000000000001
11111111111111111111